#######################################
#.....................................#
#.....................................#
#.....................................#
#.....................................#
#.....................................#
#.....................................#
#................3....................#
#.....................................#
#.....................................#
#....2.......................2........#
#.....................................#
#................2....................#
#.....................................#
#..................................####
#..................................O.h#
#..................................####
#.....................................#
#..2..........2.......................#
#.....................................#
#.......................2.............#
#.....................................#
#.....................................#
#.....................................#
#.....................................#
####..................................#
#h.O..................................#
####..................................#
#.....................................#
#............2........................#
#..............................2......#
#.2...2...............................#
#.....................................#
#.....................................#
#.....................................#
###############................########
#.............#................#......#
#.............#................#......#
#.............#................#......#
#.............#................########
#.............#.........1.............#
#.............#.......................#
###############.................1.....#
#.............#.......................#
#.............#.......................#
#.............#############.....1.....#
#.........................#.....1.....#
#.........................#...........#
#.........................#...........#
#.........................#...........#
#.........................#...........#
#.........................#...........#
#.........................#...........#
#.........................#...........#
#.........................######o######
#.........................######.######
#.........................#...........#
#.........................#...........#
#.........................#.....p.....#
#######################################
