#######################################
#.....................................#
#.....................................#
#.....................................#
#.....................................#
#.....................................#
#................3....................#
#.....................................#
#.....................................#
#....2.......................2........#
#.....................................#
#................2....................#
#.....................................#
#..................................####
#..................................O.h#
#..................................####
#.....................................#
#..2..........2.......................#
#...........#.#.......................#
#...........#.#.........2.............#
#...........#.#.......................#
#...........#1#.......................#
#...........#.#.......................#
#...........#1........................#
#...........#.#.......................#
#...........#1#.......................#
#...........#.#.......................#
#...........#.#.......................#
#...........#.#.......................#
#...........#.#.......................#
#...........#.#.......................#
#...........#.#.......................#
#...........#.#.......................#
#...........#.#.......................#
#...........#.#.......................#
#...........#.#.......................#
#...........#.#.......................#
#...........#.#.......................#
#...........#.#.......................#
#...........#.#.......................#
#...........#.#.......................#
#...........#.#.......................#
#############.#######################.#
#h.O..................................#
####..................................#
#.....................................#
#............2........................#
#..............................2......#
#.2...2...............................#
#.....................................#
#.....................................#
#.....................................#
###############................########
#.............#................#......#
#.............#................#......#
#.............#................#......#
#.............#................########
#.............#.........1.............#
#.............#.......................#
###############.................1.....#
#.............#.......................#
#.............#.......................#
#.............#############.....1.....#
#.........................#.....1.....#
#.........................#...........#
#.........................#...........#
#.........................#...........#
#.........................#...........#
#.........................#...........#
#.........................#...........#
#.........................#...........#
#.........................#...........#
#.........................#...........#
#.........................#...........#
#.........................#...........#
#.........................###o#####o###
#.........................#...........#
#.........................#...........#
#.........................#...........#
#.........................#...........#
#.........................###o#####o###
#.........................#...........#
#.........................#...........#
#.........................#...........#
#.........................#...........#
#.........................###o#####o###
#.........................#...........#
#.........................#...........#
#.........................#...........#
#.........................#...........#
#.........................###o#####o###
#.........................#...........#
#.........................#...........#
#.........................#...........#
#.........................#...........#
#.........................###o#####o###
#.........................#...........#
#.........................#...........#
#.........................#...........#
#.........................#...........#
#.........................###o#####o###
#.........................#...........#
#.........................#...........#
#.........................#...........#
#.........................#...........#
#.........................###o#####o###
#.........................#...........#
#.........................#...........#
#.........................#...........#
#.........................#...........#
#.........................###o#####o###
#.........................#...........#
#.........................#...........#
#.........................#...........#
#.........................#...........#
#.........................###o#####o###
#.........................#...........#
#.........................#...........#
#.........................#...........#
#.........................#...........#
#.........................###o#####o###
#.........................#...........#
#.........................#...........#
#.........................#...........#
#.........................#...........#
#.........................###o#####o###
#.........................#...........#
#.........................#...........#
#.........................#...........#
#.........................#...........#
#.........................###o#####o###
#.........................#...........#
#.........................#...........#
#.........................#...........#
#.........................#...........#
#.........................###o#####o###
#.........................#...........#
#.........................#...........#
#.........................#...........#
#.........................#...........#
#.........................###o#####o###
#.........................#...........#
#.........................#...........#
#.........................#...........#
#.........................#...........#
#.........................###o#####o###
#.........................#...........#
#.........................#...........#
#.........................#...........#
#.........................#...........#
#.........................###o#####o###
#.........................#...........#
#.........................#...........#
#.........................#...........#
#.........................#...........#
#.........................###o#####o###
#.........................#...........#
#.........................#...........#
#.........................#...........#
#.........................#...........#
#.........................###o#####o###
#.........................#...........#
#.........................#...........#
#.........................#...........#
#.........................#...........#
#.........................###o#####o###
#.........................#...........#
#.........................#...........#
#.........................#...........#
#.........................#...........#
#.........................###o#####o###
#.........................#...........#
#.........................#...........#
#.........................#...........#
#.........................#...........#
#.........................###o#####o###
#.........................#...........#
#.........................#...........#
#.........................#...........#
#.........................#...........#
#.........................###o#####o###
#.........................#...........#
#.........................#...........#
#.........................#...........#
#.........................#...........#
#.........................###o#####o###
#.........................#...........#
#.........................#...........#
#.........................#...........#
#.........................#...........#
#.........................###o#####o###
#.........................#...........#
#.........................#...........#
#.........................#...........#
#.........................#...........#
#.........................######o######
#.........................#...........#
#.........................#...........#
#.........................#...........#
#.........................#.....p.....#
#######################################
