#######################################
#...#.................................#
#.h.#.................................#
#...O.................................#
#####.................................#
#.....................................#
#............e........................#
#..............................e......#
#.e...e...............................#
#.....................................#
#.....................................#
#.....................................#
#.....................................#
#.....................................#
#.....................................#
#.....................................#
#.....................................#
#.......................e.............#
#.....................................#
###############.................e.....#
#.............#.......................#
#.............#.......................#
#.............#############.....e.....#
#.........................#.....e.....#
#.........................#...........#
#.........................#...........#
#.........................#...........#
#.........................#...........#
#.........................#...........#
#.........................#...........#
#.........................#...........#
#.........................######o######
#.........................######.######
#.........................#...........#
#.........................#...........#
#.........................#.....p.....#
#######################################
