#######################################
#...#.................................#
#.h.#.................................#
#...o.................................#
#####.................................#
#.....................................#
#............e........................#
#..............................e......#
#.e...e...............................#
#.....................................#
#.....................................#
#.....................................#
#.....................................#
#.....................................#
#.....................................#
#.....................................#
#.....................................#
#.....................................#
#.....................................#
###############.......................#
#.............#.......................#
#.............#.......................#
#.............#############...........#
#.........................#...........#
#.........................#........p..#
#.........................#...........#
#.........................#...........#
#.........................#...........#
#.........................#...........#
#.........................#...........#
#.........................#...........#
#.........................#...........#
#.........................#...........#
#.........................#...........#
#.........................#...........#
#.........................#...........#
#######################################
